1111111111111111111
1P000001e100h00C001
11110000000000000v1
1000001010010000001
1011101010010000001
101C101011010000001
1C1000101C010000001
1110101011110000001
1000101000C10000001
1111101111110101111
1C000000000001000C1
1111111111111111111
