1111111111
10000000e1
1P00C00001
1111111111
