1111111111
1P000001e1
1111000001
100h001c11
1111111111
