1111111111111111111
1P0ccc01e100h000001
11110V0000000000001
100h001010010000001
101110101001000h001
101C101011010000001
1C1000101C010000V01
11101010111100h0001
1000101000C10000001
1111101111110101111
1C00000h0000C1000C1
1111111111111111111
