11111111111111111111
1P1000000000100000C1
10101111110H00111111
1010V0000111111000C1
10100000110000001111
10111110100011V00001
10000010100111111111
1H000010101100000001
1000000000H00100V1C1
101111111111111111E1
10000000000000000001
11111111111111111111
