1111111111111111111
1P0CCC01e100H000001
111100000000000H001
100H001010010H00001
101110101001000H001
10101010110100H0001
10100V1010010000H01
111010101111000H001
10001010000100H0001
1111101111110101111
1C00000H000001V00C1
1111111111111111111
