11111111111111111111
1P000001e100h0000001
11110V00000000100001
100h0010100111100001
101110101001000h0001
101C1010110100000001
1C1000101C010000V001
11101010111100h00001
1000101000C100000001
11111011111101011111
1C00000h0000C10000C1
11111111111111111111
